Lists of Genkais and Elements and Kenjutsu Styles


(Name from Shindo Life) = (Name in script)


Genkais/Bloodlines:

Narumaki Ruby = narumakiruby
Akuma = sharingan
Steam = boil
Crystal = crystal
Atomic = dust
Explosion = explosion
Sand = sand
Ice = ice
Gold Sand = golddust
Scorch = scorch
Lava = lava
Apollo Sand = ironsand
Sound = sound
Mud = mud
Storm = storm
Jokei = byakugan
Kamaki Amethyst = kamakipurple
Dokei = ketsuryugan
Kokotsu = kaguya
Senko = namikaze
Raion Rengoku = raionrengoku
Azarashi = uzumaki
Minakami = shirogane
Shado = nara
Shizen = senjuwood
Glacier = yukiice
Nectar = kamizuru
Eastwood Korashi = horsemankorashi
Kamaki = kamaki
Tengoku = tenseigan
Rengoku = rinnegan
Clay = clay
Black Storm = blacklightning
Zero Glacier = subzeroice
Bankai Akuma = itachisharingan
Rykan Shizen = aduritewood
Arahaki Jokei = byakugangold
Okami = inuzuka
Dio Senko = namikazegod
Eternal = jashin
Kerada = akimichi
Ashen Storm = whitelightning
Shiver-Akuma = obitosharingan
Raion Akuma = sasukesharingan
Ink = ink
Forged Sengoku = forgedsengoku
Bubble = bubble
Konchu = aburame
Azim Senko = azimsenko
Kenchi = kenichi
Saberu = saberu
Dangan = dangan
Riser Akuma = riser
Renshiki = renshiki
Shindai Rengoku = shindairengoku
Frost-Fire = frost
Seishin = seishin
Sengoku = sengoku
Hair = hair
Inferno = inferno
Minakaze-Azure = minakazeazure
Kaijin = sarutobi
Mecha Spirit = mechaspirit
Light Jokei = lightjokei
Odin Saberu = odinsaberu
Wanizame = hoshigaki
Pika Senko = pikapika
Gold Jokei = goldjokei
Giovanni Shizen = giovannishizen
Cobra = snakegreen
Kabu Cobra = snakewhite
Jotaro Shizen = jotaroshizen
Deva Rengoku = devarengoku
Emerald = emerald
Deva Sengoku = devasengoku
Typhoon = typhoon
Ghost Korashi = ghostazarashi
Inferno Korashi = infernoazarashi
Xeno Dokei = xenodokei
Narumaki = narumaki
Narumaki Yang = narumakiyang
Nature = wood
Tsunami = tsunami
Aidens Son Mud = varietymud
Forged Rengoku = forgedrengoku
Bolt = bolt
Raion Sengoku = raionsengoku
Blood = blood
Renshiki Gold = renshikigold
Smoke = smoke
Borumaki = borumaki
Borumaki Gold = borumakigold
Satori = shisuisharingan
Sarachia-Akuma = sarachiasharingan
Minakaze = minakaze
Sarachia-Gold = sarachiasharingangold
Shindai Akuma = shindaiakuma
Shindai Yang = shindairengokuyang
Strange = drstrange
Ryuji = ryujikenichi
Vine = vine
Ryuji Platinum = ryujikenichiwhite
Jayramaki Azure = jayramazure
Raion Azure = raionazure
Bankai Inferno = bankaiinferno
Jayramaki = jayramaki
Satori Rengoku = satorirengoku
Satori Gold = satorigold
Riser Inferno = riserinferno
Doku Scorpion = dokuscorpion
Doku Tengoku = dokutengoku
Dio Senko Azure = namikazegodazure
Alphirama Shizen = alphiramashizen
Dark Jokei = darkjokei
Web = spiderman
Shiro Glacier = toshiroice
Kagoku = kagoku
Kagoku Platinum = kagokuplatinum
Sengoku Inferno = sengokuinferno
Vanhelsing = morbius
Menza = menza
Tengoku Platinum = tengokuplatinum
Obi Ren Kengoku = obirengoku
Vengeance = batman
Narumaki Six Paths = narumakisixpaths
Raion Gaiden = raiongaiden
Jinshiki = jinshikiekg
Sengoku Gaiden = sengokugaiden
Vengeance = sunknight
Dio Senko Rose = namikazegodrose
Rune Konchu = godinsect
Bruce Kenichi = brucekenichi
Fate = drfate
Renshiki Ruby = renshikiruby
Paper = paper
Gura Rengoku = whitebeardgoku
Shindai Ramen = shindairamen
Ragnar = thor NEW


Elements:

Flame Style = fire
Shock Style = lightning
Stone Style = earth
Air Style = wind
Shiver Style = purplelightning
Combustion Style = combustion
Yin Style = yin
Yang Style = yang
Acid Style = acid
Cement Style = cement
Gale Style = gale
Chaos Style = chaos
Order Style = order
Prism Style = goldlightning
Liquid Style = water
Pyromania Style = infernocombustion


Kenjutsu Styles:

Flame Style = fire
Shock Style = lightning
Stone Style = earth
Air Style = wind
Shiver Style = purplelightning
Combustion Style = combustion
Yin Style = yin
Yang Style = yang
Acid Style = acid
Cement Style = cement
Gale Style = gale
Chaos Style = chaos
Order Style = order
Prism Style = goldlightning
Liquid Style = water
Pyromania Style = infernocombustion
Water Ken Style = waterbreathing
Flame Ken Style = flamebreathing
Thunder Ken Style = thunderbreathing
Wind Ken Style = windbreathing
Mist Ken Style = mistbreathing
Moon Ken Style = moonbreathing
Sun Ken Style = sunbreathing
Inferno Ken Style = infernobreathing
Blood Moon Ken Style = bloodmoonbreathing
Shiver Ken Style = shiverbreathing
Sound Ken Style = soundbreathing
